###B###
#     #
# # # #
# # # #
#     #
### ###
###A###