###########
#A        #
# ####### #
#       # #
####### # #
#       # #
# ####### #
#       # #
####### # #
#         #
#########B#
###########
