
#### ##
#B    #
# # # #
# # # #
#     #
### ###
###A###