
###                 #########
#   ###################   #B#
# ####                # # # #
# ################### # # # #
#                     # # # #
########### ######### # # # #
#   ##                # # # #
# # ## ### ## ######### # # #
# #    #   ## #         # # #
# # ## ################ # # #
### ##             #### # # #
### ## ########### ## # # # #
###             ##    # # # #
###### #### ### ####### # # #
###### ####             #   #
A      ######################
